11111111111111111111
1P00000C000000000001
11111000000010011001
1C00000C001011000001
1C111111101000000001
1000C0000000111E0001
1000E0000000C0100001
100000000000000C0001
11111111111111111111
