11111111111
1P00000C001
1111100A001
1C00000C001
1C111111101
1000C0A0001
1000E0000E1
11111111111
